111111111111111111111
1CC1C0CCC0CC1C00CCCC1
10C001110C00000C00001
100C110000001111000C1
1P0001110E001C0000001
111111111111111111111