111111111111111111111
1C010CCCCCCC1C00CCCC1
100001110000000C00001
1P0C11E000001111000C1
1000011100001C0000001
111111111111111111111