1111111111
1C010000C1
100C011101
1P0011E001
1111111111