1111111111
10010C0001
1000011101
1P0011E001
1111111111